**************************************
*                                    *
*                                    *
*                                    *
*                                    *
*                                    *
*                                    *
*                                    *
*                                    *
*                                    *
*                                    *
*                                    *
*                                    *
*         o                          *
*              -    -                *
*                                    *
*         **                         *
*        ****                        *
*oo   h ******                 !     *
*******************    ***************